SO
NO 
AA
AA









F 33,89,97
C











111111
100101
101001
1100N1
111111