NO ./path_to_the_north_texture
SO ./path_to_the_south_texture
WE ./path_to_the_west_texture
EA ./path_to_the_east_texture

F 220,100,0
C 1,0,8

1111111111111111111111111
10000000001100000000100001
10110000011100000000100001
100100000000000000001000011
111111111011000001110000001
10000000001100000111011111111
11110111111111011100000010001
11110111111111011101010010001
11000000110101011100000010001
10000000000000001100000010001
10000000000000001101010010001
11000001110101011111011110N0111
11101101110101101111010001
11111111111111111111111111